bb,bb,bb,bb,bb,bb,bb,bb,bb,bb,bb,bb,bb,bb
bb,bt,bt,bt,bt,bt,bt,bt,bt,bt,bt,bt,bt,bb
bb,bt,bt,bt,bt,bt,bt,bt,bt,bt,bt,bt,bt,bb
bb,bt,bt,bt,bt,bt,bt,bt,bt,bt,bt,bt,bt,bb
bb,bt,bt,bt,bt,bt,pb,bt,bt,bt,bt,bt,bt,bb
bb,bt,bt,bt,bt,bt,bt,bt,bt,bt,bt,bt,bt,bb
bb,bt,bt,bt,bt,bt,bt,bt,bt,bt,bt,bt,bt,bb
bb,bt,bt,bt,bt,bt,bt,bt,bt,bt,bt,bt,bt,bb
bb,bb,bb,bb,bb,bb,bb,bb,bb,bb,bb,bb,bb,bb
