0,0,0,bat,0,0,0,0,0,0,0,0,
0,0,0,0,0,0,0,0,0,0,bat,0,
0,0,0,0,0,0,0,0,0,0,0,0,
0,0,0,0,0,0,0,0,0,0,0,bat,
0,0,0,0,0,bat,0,bat,0,0,0,0,
0,0,0,0,0,0,0,0,0,0,bat,0,
0,0,0,bat,0,0,0,0,0,0,0,0,
,,,,,,,,,,,,
,,,,,,,,,,,,
