bw,bw,bw,bw,bw,bw,bw,bw,bw,bw,bw,bw,bw,bw
bw,bt,bt,bt,bt,bt,bt,bt,bt,bt,bt,bt,bt,bw
bw,bt,bt,bt,bt,bt,bt,bw,bt,bt,bt,bt,bt,bw
bw,bt,bt,bt,bt,bt,bw,bt,bw,bt,bt,bt,bt,bw
bw,bt,bt,bt,bt,pbu,bt,bstairs,bt,bw,bt,bt,bt,bw
bw,bt,bt,bt,bt,bt,bw,bt,bw,bt,bt,bt,bt,bw
bw,bt,bt,bt,bt,bt,bt,bw,bt,bt,bt,bt,bt,bw
bw,bt,bt,bt,bt,bt,bt,bt,bt,bt,bt,bt,bt,bw
bw,bw,bw,bw,bw,bw,bw,bw,bw,bw,bw,bw,bw,bw
