bb,bb,bb,bb,bb,bb,bb,bb,bb,bb,bb,bb,bb,bb,bb,bb
bb,bb,bb,bb,bb,bb,bb,bb,bb,bb,bb,bb,bb,bb,bb,bb
bb,bb,bt,bt,bt,bt,bt,bt,bt,bt,bt,bt,bt,bt,bb,bb
bb,bb,bt,bw,bw,bw,bw,bw,bw,bw,bw,bw,bw,bt,bb,bb
bb,bb,bt,bw,bt,bt,bsl,bt,bt,bsr,bt,bt,bw,bt,bb,bb
rtb,0,bt,bw,bt,bsl,bt,bt,bt,bt,bsr,bt,bw,bt,bb,bb
bb,bb,bt,bw,bt,bt,bt,bt,bt,bt,bt,bt,bw,bt,bb,bb
bb,bb,bt,bw,bw,bw,bw,bt,bt,bw,bw,bw,bw,bt,bb,bb
bb,bb,bt,bt,bt,bt,bt,bt,bt,bt,bt,bt,bt,bt,bb,bb
bb,bb,bb,bb,bb,bb,bb,bb,bb,bb,bb,bb,bb,bb,bb,bb
bb,bb,bb,bb,bb,bb,bb,bb,bb,bb,bb,bb,bb,bb,bb,bb
