bw,bw,bw,bw,bw,bw,bw,bw,bw,bw,bw,bw,bw,bw
bw,bt,bt,bt,bt,bt,bt,bt,bt,bt,bt,bt,bt,bw
bw,bt,bw,bw,bw,bw,bw,bw,bw,bw,bw,bw,bt,bw
bw,bt,bw,bt,bt,bsl,bt,bt,bsr,bt,bt,bw,bt,bw
bw,bt,bw,bt,bsl,bt,bt,bt,bt,bsr,bt,bw,bt,bw
bw,bt,bw,bt,bt,bt,bt,bt,bt,bt,bt,bw,bt,bw
bw,bt,bw,bw,bw,bw,bt,bt,bw,bw,bw,bw,bt,bw
bw,bt,bt,bt,bt,bt,bt,bt,bt,bt,bt,bt,bt,bw
bw,bw,bw,bw,bw,bw,bw,bw,bw,bw,bw,bw,bw,bw
