bb,bb,bb,bb,bb,bb,bb,bb,bb,bb,bb,bb,bb,bb
bb,bt,bt,bt,bt,bt,bt,bt,bt,bt,bt,bt,bt,bb
bb,bt,bt,bt,bt,bt,bt,bt,bt,bt,bt,bt,bt,bb
bb,bt,bt,bt,bt,bt,bw,bw,bt,bt,bt,bt,bt,bb
bb,bt,bt,bt,bt,bt,bw,bw,bt,bt,bt,bt,bt,bb
bb,bt,bt,bt,bt,bt,bw,bw,bt,bt,bt,bt,bt,bb
bb,bt,bt,bt,bt,bt,bt,bt,bt,bt,bt,bt,bt,bb
bb,bt,bt,bt,bt,bt,bt,bt,bt,bt,bt,bt,bt,bb
bb,bb,bb,bb,bb,bb,bb,bb,bb,bb,bb,bb,bb,bb
