bw,bw,bw,bw,bw,bw,bw,bw,bw,bw,bw,bw,bw,bw
bw,bt,bt,bt,bt,bt,bt,bt,bw,bw,bw,bw,bw,bw
bw,bt,bt,bt,bt,bt,bt,bt,bt,bw,bw,bw,bw,bw
bw,bt,bt,bt,bt,bt,bt,bt,bt,bt,bw,bw,bw,bw
bw,bt,bt,bt,bt,bt,bt,bt,bt,bt,bt,bt,bt,bw
bw,bt,bt,bt,bt,bt,bt,bt,bt,bt,bw,bw,bw,bw
bw,bt,bt,bt,bt,bt,bt,bt,bt,bw,bw,bw,bw,bw
bw,bt,bt,bt,bt,bt,bt,bt,bw,bw,bw,bw,bw,bw
bw,bw,bw,bw,bw,bw,bw,bw,bw,bw,bw,bw,bw,bw
