bb,bb,bb,bb,bb,bb,bb,bb,bb,bb,bb,bb,bb,bb
bb,bt,bt,bt,bt,bt,bt,bt,bw,bw,bw,bw,bw,bb
bb,bt,bt,bt,bt,bt,bt,bt,bt,bw,bw,bw,bw,bb
bb,bt,bt,bt,bt,bt,bt,bt,bt,bt,bw,bw,bw,bb
bb,bt,bt,bt,bt,bt,bt,bt,bt,bt,bt,bt,bt,bb
bb,bt,bt,bt,bt,bt,bt,bt,bt,bt,bw,bw,bw,bb
bb,bt,bt,bt,bt,bt,bt,bt,bt,bw,bw,bw,bw,bb
bb,bt,bt,bt,bt,bt,bt,bt,bw,bw,bw,bw,bw,bb
bb,bb,bb,bb,bb,bb,bb,bb,bb,bb,bb,bb,bb,bb
