bb,bb,bb,bb,bb,bb,bb,bb,bb,bb,bb,bb,bb,bb
bb,bt,bt,bt,bt,bt,bt,bt,bt,bt,bt,bt,bt,bb
bb,bt,bw,bt,bw,bt,bw,bw,bt,bw,bt,bw,bt,bb
bb,bt,bt,bt,bt,bt,bt,bt,bt,bt,bt,bt,bt,bb
bb,bt,bw,bt,bw,bt,bw,bw,bt,bw,bt,bw,bt,bb
bb,bt,bt,bt,bt,bt,bt,bt,bt,bt,bt,bt,bt,bb
bb,bt,bw,bt,bw,bt,bw,bw,bt,bw,bt,bw,bt,bb
bb,bt,bt,bt,bt,bt,bt,bt,bt,bt,bt,bt,bt,bb
bb,bb,bb,bb,bb,bb,bb,bb,bb,bb,bb,bb,bb,bb
